15 29
WWWWWWWWWWWWWWWWWWWWWWWWWWWWW
WNNNNNNNNNWWNNNNNNNNNNNNNNNNW
WNNNNNNNNNWWNNNNNNNNNNNNNNNNW
WNWNNNNNNNWWWWNNNNNNNNNNNNNNW
WNWWWWWNNNNWWWNNNNWWWNNNNNNNW
WNWWNWWNNNNNNNNNNNWWNNNNNNNNW
WNNNNNWNNNNNNNNNNNNNNNNWWWWNW
WNNNNNWNNNNNNNNNNNNNNNNWWNNNW
WNNWNNWNNNNWWWNNNNNNNNNWWNNNW
WNNWWWWNNNNWWWWNNNNNNNWWWNNNW
WNNNNNNNNNNWNNNNNNNNNNWWWWNWW
WNNNNNNNNNNNNNNNNNNNNNWWWWNWW
WNNNNNNNNNNNNNWWNNNNNNNNNNNNW
WNNNNNNNNNNNNNWWNNNNNNNNNNNNW
WWWWWWWWWWWWWWWWWWWWWWWWWWWWW
